{
	"name" : "test",
	"width" : 20,
	"height" : 2,
	"nodes" :
	[
		2,2,2,2,2,2,2,2,2,2,2,2,2,2,2,2,2,2,2,2,
		2,2,2,2,2,2,2,2,2,2,2,2,2,2,2,2,2,2,2,2,
		2,2,2,2,2,2,2,2,2,2,2,2,2,2,2,2,2,2,2,2,
		2,2,2,2,2,2,2,2,2,2,2,2,2,2,2,2,2,2,2,2,
		2,2,2,2,2,2,3,2,2,3,3,2,2,2,2,2,2,2,2,2,
		2,2,2,2,2,3,3,2,2,3,3,2,2,2,2,2,2,2,2,2,
		2,2,2,2,2,3,3,2,2,3,3,2,2,2,2,2,2,2,2,2,
		2,2,2,2,3,3,3,3,3,3,3,3,3,3,3,2,2,2,2,2,
		2,2,2,2,3,3,3,3,3,3,3,3,3,3,3,2,2,2,2,2,
		2,2,2,3,3,3,3,3,3,3,3,3,3,3,3,2,2,2,2,2,
		2,2,3,3,3,3,3,3,3,3,3,3,3,3,3,2,2,2,2,2,
		2,2,2,2,3,3,3,3,3,3,3,3,3,3,3,3,3,3,2,2,
		2,2,2,2,3,3,3,3,3,3,3,3,3,3,3,2,2,3,2,2,
		2,2,2,2,2,2,2,2,2,2,2,3,3,2,2,2,2,3,3,3,
		2,2,2,2,2,2,2,2,2,2,2,3,3,2,2,2,2,2,2,2,
		2,2,2,2,2,2,2,2,2,2,2,3,3,2,2,2,2,2,2,2,
		2,2,2,2,2,2,2,2,2,2,2,3,3,2,2,2,3,3,3,2,
		2,2,2,2,2,2,2,2,2,2,2,3,3,2,2,2,3,3,3,2,
		2,2,2,2,2,2,2,2,2,2,2,3,3,2,2,2,3,3,3,2,
		2,2,2,2,2,2,2,2,2,2,2,2,2,2,2,2,2,2,2,2,
		
		1,1,1,1,1,1,1,1,1,1,1,1,1,1,1,1,1,1,1,1,
		1,0,0,0,0,1,0,0,0,0,0,1,0,0,0,0,0,0,0,1,
		1,0,0,0,0,1,0,0,0,0,0,1,0,0,0,0,0,0,0,1,
		1,0,4,4,0,1,0,0,0,0,0,1,0,0,0,0,0,0,0,1,
		1,0,4,4,0,1,0,0,0,0,0,1,0,0,0,0,0,0,0,1,
		1,0,0,4,0,1,0,0,0,0,0,1,1,0,1,1,1,1,4,1,
		1,0,0,4,0,1,0,0,0,0,0,0,0,0,0,1,1,4,4,1,
		1,0,0,0,0,1,0,0,0,0,0,0,0,0,0,0,1,1,4,1,
		1,1,1,0,1,1,0,0,0,0,0,1,0,0,0,0,0,1,1,1,
		1,0,0,0,0,0,0,0,0,0,0,1,0,0,0,0,0,0,1,1,
		1,0,0,0,0,0,0,0,0,0,0,1,0,0,0,0,0,0,0,1,
		1,0,0,0,0,0,0,0,0,0,0,1,0,0,0,0,0,0,0,1,
		1,0,0,1,1,0,1,1,0,0,0,1,0,0,0,0,0,0,0,1,
		1,0,0,1,0,0,0,1,0,0,0,1,0,0,0,0,0,0,4,1,
		1,0,0,1,0,0,0,1,0,0,0,1,0,0,0,0,1,0,4,1,
		1,0,0,1,0,0,0,1,0,0,0,1,0,0,0,0,1,0,4,1,
		1,0,0,1,1,0,1,1,0,0,0,1,0,0,0,0,1,4,4,1,
		1,0,0,0,0,0,0,0,0,0,0,1,0,0,0,4,1,4,4,1,
		1,0,0,0,0,0,0,0,0,0,0,1,0,0,4,4,4,4,4,1,
		1,1,1,1,1,1,1,1,1,1,1,1,1,1,1,1,1,1,1,1
		
	],
	"slopes" :
	[
		0,0,0,0,0,0,0,0,0,0,0,0,0,0,0,0,0,0,0,0,
		0,0,0,0,0,0,0,0,0,0,0,0,0,0,0,0,0,0,0,0,
		0,0,0,0,0,0,0,0,0,0,0,0,0,0,0,0,0,0,0,0,
		0,0,0,0,0,0,0,0,0,0,0,0,0,0,0,0,0,0,0,0,
		0,0,0,0,0,0,0,0,0,0,0,0,0,0,0,0,0,0,0,0,
		0,0,0,0,0,0,0,0,0,0,0,0,0,0,0,0,0,0,0,0,
		0,0,0,0,0,0,0,0,0,0,0,0,0,0,0,0,0,0,0,0,
		0,0,0,0,0,0,0,0,0,0,0,0,0,0,0,0,0,0,0,0,
		0,0,0,0,0,0,0,0,0,0,0,0,0,0,0,0,0,0,0,0,
		0,0,0,0,0,0,0,0,0,0,0,0,0,0,0,0,0,0,0,0,
		0,0,0,0,0,0,0,0,0,0,0,0,0,0,0,0,0,0,0,0,
		0,0,0,0,0,0,0,0,0,0,0,0,0,0,0,0,0,0,0,0,
		0,0,0,0,0,0,0,0,0,0,0,0,0,0,0,0,0,0,0,0,
		0,0,0,0,0,0,0,0,0,0,0,0,0,0,0,0,0,0,0,0,
		0,0,0,0,0,0,0,0,0,0,0,0,0,0,0,0,0,0,0,0,
		0,0,0,0,0,0,0,0,0,0,0,0,0,0,0,0,0,0,0,0,
		0,0,0,0,0,0,0,0,0,0,0,0,0,0,0,0,0,0,0,0,
		0,0,0,0,0,0,0,0,0,0,0,0,0,0,0,0,0,0,0,0,
		0,0,0,0,0,0,0,0,0,0,0,0,0,0,0,0,0,0,0,0,
		0,0,0,0,0,0,0,0,0,0,0,0,0,0,0,0,0,0,0,0,

		0,0,0,0,0,0,0,0,0,0,0,0,0,0,0,0,0,0,0,0,
		0,0,0,0,0,0,0,0,0,0,0,0,0,0,0,0,0,0,0,0,
		0,0,0,0,0,0,0,0,0,0,0,0,0,0,0,0,0,0,0,0,
		0,0,0,0,0,0,0,0,0,0,0,0,0,0,0,0,0,0,0,0,
		0,0,0,0,0,0,0,0,0,0,0,0,0,0,0,0,0,0,0,0,
		0,0,0,0,0,0,0,0,0,0,0,0,0,0,0,0,0,0,0,0,
		0,0,0,0,0,0,0,0,0,0,0,0,0,0,0,0,0,0,0,0,
		0,0,0,0,0,0,0,0,0,0,0,0,0,0,0,0,0,0,0,0,
		0,0,0,0,0,0,0,0,0,0,0,0,0,0,0,0,0,0,0,0,
		0,0,0,0,0,0,0,0,0,0,0,0,0,0,0,0,0,0,0,0,
		0,0,0,0,0,0,0,0,0,0,0,0,0,0,0,0,0,0,0,0,
		0,0,0,0,0,0,0,0,0,0,0,0,0,0,0,0,0,0,0,0,
		0,0,0,0,0,0,0,0,0,0,0,0,0,0,0,0,0,0,0,0,
		0,0,0,0,0,0,0,0,0,0,0,0,0,0,0,0,0,0,0,0,
		0,0,0,0,0,0,0,0,0,0,0,0,0,0,0,0,0,0,0,0,
		0,0,0,0,0,0,0,0,0,0,0,0,0,0,0,0,0,0,0,0,
		0,0,0,0,0,0,0,0,0,0,0,0,0,0,0,0,0,0,0,0,
		0,0,0,0,0,0,0,0,0,0,0,0,0,0,0,0,0,0,0,0,
		0,0,0,0,0,0,0,0,0,0,0,0,0,0,0,0,0,0,0,0,
		0,0,0,0,0,0,0,0,0,0,0,0,0,0,0,0,0,0,0,0

	]

}
